w...w..w.p..w
.w.x...w...w.
..w....x..w..
w..*.w..w...w
...w......p..
w.x..w..m..w.
..w...w....w.
p..w..x..w...
w....w..w.m..
..x...w....w.
w..p..m..g..w
...w....w...w
wwwwwwwwwwwww