w.p.w...w..xw
..x..w.m...w.
w..w....p..w.
..*.w..x.w...
w...m..w...w.
..w....m..p..
x..w..w....w.
w....x..w.m..
..p.w...w...w
w..m..w..g..x
...w....p..w.
w.x..w..w...w
wwwwwwwwwwwww